[console_scripts]
combine-EOS = nmma.em.combine_EOS:main
convert-skyportal-lcs = tools.convert_skyportal_lcs:main
create-lightcurve-condor = nmma.em.create_lightcurves_condor:main
create-lightcurve-slurm = nmma.em.create_lightcurves_slurm:main
create-svdmodel = nmma.em.create_svdmodel:main
gwem-Hubble-estimate = nmma.em.gwem_Hubble_estimate:main
gwem-resampling = nmma.em.gwem_resampling:main
gwem-resampling-condor = nmma.em.gwem_resampling_condor:main
lightcurve-analysis = nmma.em.analysis:main
lightcurve-analysis-condor = nmma.em.analysis_condor:main
lightcurve-analysis-lbol = nmma.em.analysis_lbol:main
lightcurve-detection = nmma.em.detect_lightcurves:main
lightcurve-generation = nmma.em.create_lightcurves:main
lightcurve-injection-condor-setup = nmma.em.create_injection_condor:main
lightcurve-injection-slurm-setup = nmma.em.create_injection_slurm:main
lightcurve-injection-summary = nmma.em.injection_summary:main
lightcurve-manual = nmma.em.manual:main
lightcurve-marginalization = nmma.em.lightcurve_marginalization:main
lightcurve-validation = nmma.em.validate_lightcurve:main
maximum-mass-constraint = nmma.joint.maximum_mass_constraint:main
multi-config-analysis = nmma.em.multi_config_analysis:main
nmma-analysis = nmma.pbilby.analysis:main_nmma
nmma-create-injection = nmma.eos.create_injection:main
nmma-generation = nmma.pbilby.generation:main_nmma
nmma-gw-analysis = nmma.pbilby.analysis:main_nmma_gw
nmma-gw-generation = nmma.pbilby.generation:main_nmma_gw
plot-svdmodel-benchmarks = tools.plot_svdmodel_benchmarks:main
resample-grid = tools.resample_grid:main
svdmodel-benchmark = nmma.em.svdmodel_benchmark:main
svdmodel-download = nmma.utils.models:main
